###################################
####                              #
####                              #
####                              ¤
#                                 #
#                                 #
###################################